Second Chance, by Taggart Ashby

Chapter 1: Where am I?

You wake up with a splitting headache, so bad you swear you've been hit with a bat.

Foyer
Slowly the world comes into focus and you find yourself in a house. As you stand up and brush yourself off, small dust clouds form. To the west is the front door, ornate and grand, but splintered and buckling after what appears to be decades of neglect. To the east is the foyer door leading further into the house. On the wall in front of you hangs a picture. Behind you there is a bookcase filled with dusty books. To get any more details, you'd have to take a closer look.

>read
That's not a verb I recognize.

* * *

>touch
What do you want to touch?

>touch books
You feel nothing unexpected.

>take books
You're afraid if you even touch them they will fall apart.

* * *

>x dinosaur book
You see nothing special about the dinosaur book.

>x herp book
You can't see any such thing.

>read
What do you want to read?

>read dinosaur book
You see nothing special about the dinosaur book.

>read picture
The frame is barely holding together. The picture is unrecognizeable from the decay and water damage.  

You hear a faint whizz coming from all around, what you imagine magic would sound like, if such a thing were real.

* * *

>take dinosaur book
That's hardly portable.

* * *

>x boks
You can't see any such thing.

>x books
The books are dirty and falling apart. Pages are ripped and the spines of most of them are barely staying together.   

You hear a faint whizz coming from all around, what you imagine magic would sound like, if such a thing were real.

>x picture
The frame is barely holding together. The picture is unrecognizeable from the decay and water damage.  

Something strange is happening to the house…

Chapter 2: Old Memories

 Suddenly the house becomes more lively. The dust and rot have vanished and everything is in better condition. The foyer door lock clicks and you can see that it's now unlocked.

Foyer
You can't believe your eyes! The front door slowly fills in its cracks with new wood and paint, rust dissolving from the hinges. The picture comes back into focus. The spines on the books stiffen and strengthen. To the east is the foyer door. You can make out the picture now, a family portrait. The bookcase shines a little, the remnants of a lacquer applied a while ago, and book titles can be seen. 

This is your childhood home, a little more beat up than you remember though.

>e
(first opening the foyer door)
The hinges of the door squeak as you open it and move through.

>l
Play Room
You are in the play room. You used to spend all day in here with your pile of toys. There a pile of pile of toys on the floor, discarded, old, and heavy used.

>x toys
You see nothing special about the pile of toys.

* * *

>x picture
The frame is barely holding together. The picture is unrecognizeable from the decay and water damage.  

You hear a faint whizz coming from all around, what you imagine magic would sound like, if such a thing were real.

>x frame
The frame is barely holding together. The picture is unrecognizeable from the decay and water damage.  

You hear a faint whizz coming from all around, what you imagine magic would sound like, if such a thing were real.

* * *

>x picture
The frame is barely holding together. The picture is unrecognizeable from the decay and water damage.  

You hear a faint whizz coming from all around, what you imagine magic would sound like, if such a thing were real.

>x books
The books are dirty and falling apart. Pages are ripped and the spines of most of them are barely staying together.  

Something strange is happening to the house

Chapter 2: Old Memories

Suddenly the house becomes more lively. The dust and rot have vanished and everything is in better condition. The foyer door lock clicks and you can see that it's now unlocked.

Foyer
You can't believe your eyes! The front door slowly fills in its cracks with new wood and paint, rust dissolving from the hinges. The picture comes back into focus. The spines on the books stiffen and strengthen. To the east is the foyer door. You can make out the picture now, a family portrait. The bookcase shines a little, the remnants of a lacquer applied a while ago, and book titles can be seen. 

This is your childhood home, a little more beat up than you remember though.

>take books
That's hardly portable.

>take book
That's fixed in place.

>take book
That's fixed in place.

>x bookcase
Just your standard bookcase really, full of books.

In the bookcase is a dinosaur book.

* * *

>e
(first opening the foyer door)
Floor boards creak and moan.

Play Room
You are in the play room. You used to spend all day in here with your toys. There is a pile of toys on the floor, discarded, old, and heavy used. To the north is a door with "Bath" written on it in fading gold paint. To the south is door with "Nursery" written on it in the same fading paint. To the east is a door with nothing written on it. Back to the west is the Foyer.

>x toys
The toys are broken or nearly broken from intense use, no one ever said you were gentle with your toys. 

It sounds as though something will happen like last time if you keep at it...

>n
(first opening the bathroom door)
Floor boards creak and moan.

Bathroom
On your right is a bathtub, off-white with rings in some corners from shampoo bottles that once sat there. On your left is the bathroom counter, on which are some toothbrushes. Attached to the left wall is a large mirror. 

You can see a rubber ducky here.

>take rubber ducky
Taken.

>x ducky
There's a rubber duck! Now you remember; your parents bought it and you would chew on it while they bathed you. No bite marks on it now though. It always brought you luck and you think of taking it with you.

>e
You can't go that way.

The only way to go is south.

>s
The hinges of the door squeak as you open it and move through.

Play Room
You are in the play room. You used to spend all day in here with your toys. There is a pile of toys on the floor, discarded, old, and heavy used. To the north is a door with "Bath" written on it in fading gold paint. To the south is door with "Nursery" written on it in the same fading paint. To the east is a door with nothing written on it. Back to the west is the Foyer.

>n
Floor boards creak and moan.

Bathroom
On your right is a bathtub, off-white with rings in some corners from shampoo bottles that once sat there. On your left is the bathroom counter, on which are some toothbrushes. Attached to the left wall is a large mirror.

>x mirror
The mirror is dotted with toothpaste mishaps and steam residue. 

There's that whizzing sound again...

>x toothbrushes
The toothbrushes show signs of wear, the bristles not all pointing the same way. Brushing your teeth was always something you tolerated. Not great, but way better than the baths. 

It sounds as though something will happen like last time if you keep at it...

>toothbrushes
That's not a verb I recognize.

>container
That's not a verb I recognize.

>l
Bathroom
On your right is a bathtub, off-white with rings in some corners from shampoo bottles that once sat there. On your left is the bathroom counter, on which are some toothbrushes. Attached to the left wall is a large mirror.

>x mirror
The mirror is dotted with toothpaste mishaps and steam residue.

>x bathtub
You never cared for baths, still don't know a single child who did. Now you'd shower all day if you could, funny how things change. 

You hear the magic sound once again...

>x counter
The grout in between the tiles is dark brown. There's a sink and a toothbrush container. 

It sounds as though something will happen like last time if you keep at it...

>s
Dust clouds surround your feet as you walk.

Play Room
You are in the play room. You used to spend all day in here with your toys. There is a pile of toys on the floor, discarded, old, and heavy used. To the north is a door with "Bath" written on it in fading gold paint. To the south is door with "Nursery" written on it in the same fading paint. To the east is a door with nothing written on it. Back to the west is the Foyer.

>s
(first opening the nursery door)
Floor boards creak and moan.

Nursery
Covering the walls is a yellow patterned wallpaper, faded and peeling. On the opposite wall is the crib, blankets hang off the edge and through the open slots in the front you can see that the bed is haphazardly made. There's a brown cushy chair beside the crib where your parents used to sit when they read to you. The fuzz is worn down on the seat and in the middle of the back. To your immediate right is a dresser, chunks are missing from one of the legs where the door would always hit it. 

Above the crib hangs a mobile of the solar system. Saturn is missing a ring.

>x mobile
The complete solar system, even Pluto!

There's that whizzing sound again...

>x saturn
You can't see any such thing.

>x ring
Saturn's ring is no where to be found. 

It sounds as though something will happen like last time if you keep at it...

Chapter 3: New Beginnings

The house becomes vibrant. Washed out colors return to their former glory, dirt and dust cease to exist, all signs of wear disappear.

Nursery
The walls are practically shining from the yellow. How did your parents stand being in this room? How did you stand being in this room? The crib is pristine, the little bed ready to be slept on, the blankets tucked in just right. The brown cushy chair is furry and welcoming. Your old dresser is clean and in tact.

The whole solar system is there, and hey!, there's Saturn's ring. 

It's like you never grew up... if only.

>x chair
The chair is brand new, no marks, no scuffs. You miss those days when life was simple and you listened to your parents tell stories.

>x wallpaper
The wallpaper gleams, from certain angles the wallpaper appears completely white from the reflection of the overhead light.

>x crib
The pillow is fluffed and the blankets are tucked in and placed with precision. Nothing is out of place, it doesn't even seem used.

>x blankets
Tucked into the crib perfectly. Your parents just had to pull them back a little and slide you in, cozy and warm.

>n
Play Room
All of your favorite toys lie on the floor, they look like they've just been unpackaged. You can't help but feel excited all over again. To the north is a door with "Bath" written on it in shining gold paint. To the south is door with "Nursery" written on it in the same glinting paint. To the east is a door with nothing written on it. Back to the west is the Foyer.

>i
You are carrying:
  a rubber ducky

>w
Foyer
The novelty still hasn't worn off. The front door is beautiful, hand-crafted designs etched into the rich mahogany. The picture is crystal clear, as if it were printed yesterday. The books are clean and look like they've never been opened. To the east is the door to the Play Room.

You can see a dinosaur book here.

>x book
You haven't seen that dinosaur book in a long time. You loved that book as a kid! Heck, you knew the names of every one of those dinosaurs. You think you may just take it for old times sake.

>take book
Taken.

>l
Foyer
The front door is beautiful, hand-crafted designs etched into the rich mahogany. The picture is crystal clear, as if it were printed yesterday. The books are clean and look like they've never been opened. To the east is the door to the Play Room.

>e
Play Room
All of your favorite toys lie on the floor, they look like they've just been unpackaged. You can't help but feel excited all over again. To the north is a door with "Bath" written on it in shining gold paint. To the south is door with "Nursery" written on it in the same glinting paint. To the east is a door with nothing written on it. Back to the west is the Foyer.

>n
Bathroom
The bathtub enamel is a pure white, radiant and clean. The toothbrushes sit on the counter, their bristles stiff and unbent. The mirror is very clean.

>s
Play Room
All of your favorite toys lie on the floor, they look like they've just been unpackaged. You can't help but feel excited all over again. To the north is a door with "Bath" written on it in shining gold paint. To the south is door with "Nursery" written on it in the same glinting paint. To the east is a door with nothing written on it. Back to the west is the Foyer.

>s
Nursery
The walls are practically shining from the yellow. How did your parents stand being in this room? How did you stand being in this room? The crib is pristine, the little bed ready to be slept on, the blankets tucked in just right. The brown cushy chair is furry and welcoming. Your old dresser is clean and in tact.

The whole solar system is there, and hey!, there's Saturn's ring.

>take mobile
Taken.

The Play Room is beckoning you, maybe you should head north.

>north
Play Room
All of your favorite toys lie on the floor, they look like they've just been unpackaged. You can't help but feel excited all over again. To the north is a door with "Bath" written on it in shining gold paint. To the south is door with "Nursery" written on it in the same glinting paint. To the east is a door with nothing written on it. Back to the west is the Foyer.

Final Chapter: The End

The house grows all around you as you shrink down to a baby. Your mind is racing, this can't be real! You scream for help. Your parents open the door to the east and come in. You yell for help, but none of your words are coherent. Your parents scoop you up and rock you back and forth. You try to tell them what's going on, but they can't understand you. Suddenly all the mistakes you've made in your life cascade through your head like a damn let loose: relationships you should have ended sooner, relationships you shouldn't haven't ended, those decisions you made, the terrible things you did to people you cared for, beating yourself up for things you had no control over, ..... You calm down and your parents set you back down to play with your toys and mobile, dinosaur book and rubber ducky.

    *** You breath a sigh of relief. You're getting a second chance... ***

Would you like to RESTART, RESTORE a saved game, QUIT or UNDO the last command?

* * *

>e
(first opening the foyer door)
Floor boards creak and moan.

Play Room
You are in the play room. You used to spend all day in here with your toys. There is a pile of toys on the floor, discarded, old, and heavy used. To the north is a door with "Bath" written on it in fading gold paint. To the south is door with "Nursery" written on it in the same fading paint. To the east is a door with nothing written on it. Back to the west is the Foyer.

>n
(first opening the bathroom door)
The hinges of the door squeak as you open it and move through.

Bathroom
On your right is a bathtub, off-white with rings in some corners from shampoo bottles that once sat there. On your left is the bathroom counter, on which are some toothbrushes. Attached to the left wall is a large mirror.

>take ducky
Taken.

>x crib
You can't see any such thing.

>x mirror
The mirror is dotted with toothpaste mishaps and steam residue. 

You hear the magic sound once again...

>x counter
The grout in between the tiles is dark brown. There's a sink and a toothbrush container. 

There's that whizzing sound again...

>x toothbrushes
The toothbrushes show signs of wear, the bristles not all pointing the same way. Brushing your teeth was always something you tolerated. Not great, but way better than the baths. 

You hear the magic sound once again...

>s
The hinges of the door squeak as you open it and move through.

Play Room
You are in the play room. You used to spend all day in here with your toys. There is a pile of toys on the floor, discarded, old, and heavy used. To the north is a door with "Bath" written on it in fading gold paint. To the south is door with "Nursery" written on it in the same fading paint. To the east is a door with nothing written on it. Back to the west is the Foyer.

>x toys
The toys are broken or nearly broken from intense use, no one ever said you were gentle with your toys. 

There's that whizzing sound again...

>s
(first opening the nursery door)
Dust clouds surround your feet as you walk.

Nursery
Covering the walls is a yellow patterned wallpaper, faded and peeling. On the opposite wall is the crib, blankets hang off the edge and through the open slots in the front you can see that the bed is haphazardly made. There's a brown cushy chair beside the crib where your parents used to sit when they read to you. The fuzz is worn down on the seat and in the middle of the back. To your immediate right is a dresser, chunks are missing from one of the legs where the door would always hit it. 

Above the crib hangs a mobile of the solar system. Saturn is missing a ring.

>x crib
This is where you slept for a long while. You don't rememeber it being so agitated, but you were just a little kid. You can now understand the futility of making the bed for a child, your parents must have given up at some point. 

You hear the magic sound once again...

>x chair
Your parents used to read to you in this chair, and it shows. You can tell exactly where they sat just by the worn in pattern. 

It sounds as though something will happen like last time if you keep at it...

>x dresser
The dresser has seen better days, but it still functions. You open and close the drawers, nothing of interest in there. 

You hear the magic sound once again...

Chapter 3: New Beginnings

The house becomes vibrant. Washed out colors return to their former glory, dirt and dust cease to exist, all signs of wear disappear.

Nursery
The walls are practically shining from the yellow. How did your parents stand being in this room? How did you stand being in this room? The crib is pristine, the little bed ready to be slept on, the blankets tucked in just right. The brown cushy chair is furry and welcoming. Your old dresser is clean and in tact.

The whole solar system is there, and hey!, there's Saturn's ring. 

It's like you never grew up... if only.

>take mobile
Taken.

>e
You can't go that way.

The only way to go is north.

>n
Play Room
All of your favorite toys lie on the floor, they look like they've just been unpackaged. You can't help but feel excited all over again. To the north is a door with "Bath" written on it in shining gold paint. To the south is door with "Nursery" written on it in the same glinting paint. To the east is a door with nothing written on it. Back to the west is the Foyer.

>e
(first opening the mystery door)
It seems to be locked.

>w
Foyer
The novelty still hasn't worn off. The front door is beautiful, hand-crafted designs etched into the rich mahogany. The picture is crystal clear, as if it were printed yesterday. The books are clean and look like they've never been opened. To the east is the door to the Play Room.

You can see a dinosaur book here.

>take book
Taken.

The Play Room is beckoning you, maybe you should head east.

>e
Play Room
All of your favorite toys lie on the floor, they look like they've just been unpackaged. You can't help but feel excited all over again. To the north is a door with "Bath" written on it in shining gold paint. To the south is door with "Nursery" written on it in the same glinting paint. To the east is a door with nothing written on it. Back to the west is the Foyer.

The mysterious door seems to be unlocked.

>e
(first opening the mystery door)

Parent's Room
Final Chapter: The End

The house grows all around you as you shrink down to a baby. Your mind is racing, this can't be real! You scream for help. Your parents just look at you and smile. You yell for help, but none of your words are coherent. Your parents scoop you up and rock you back and forth. You try to tell them what's going on, but they can't understand you. Suddenly all the mistakes you've made in your life cascade through your head like a dam let loose: relationships you should have ended sooner, relationships you shouldn't haven't ended, those decisions you made, the terrible things you did to people you cared for, beating yourself up for things you had no control over, ..... so many memories. You calm down and your parents set you back down in the Play Room to play with your toys and dinosaur book, mobile and rubber ducky.

    *** You breath a sigh of relief. You're getting a second chance... ***

Would you like to RESTART, RESTORE a saved game, QUIT or UNDO the last command?

>undo
Play Room
[Previous turn undone.]

>l
Play Room
All of your favorite toys lie on the floor, they look like they've just been unpackaged. You can't help but feel excited all over again. To the north is a door with "Bath" written on it in shining gold paint. To the south is door with "Nursery" written on it in the same glinting paint. To the east is a door with nothing written on it. Back to the west is the Foyer.

The mysterious door seems to be unlocked.

>e
(first opening the mystery door)

Parent's Room
Final Chapter: The End

The house grows all around you as you shrink down to a baby. Your mind is racing, this can't be real! You scream for help. Your parents just look at you and smile. You yell for help, but none of your words are coherent. Your parents scoop you up and rock you back and forth. You try to tell them what's going on, but they can't understand you. Suddenly all the mistakes you've made in your life cascade through your head like a dam let loose: relationships you should have ended sooner, relationships you shouldn't haven't ended, those decisions you made, the terrible things you did to people you cared for, beating yourself up for things you had no control over, ..... so many memories. You calm down and your parents set you back down in the Play Room to play with your toys and dinosaur book, mobile and rubber ducky.

    *** You breath a sigh of relief. You're getting a second chance... ***

Would you like to RESTART, RESTORE a saved game, QUIT or UNDO the last command?

* * *

>n
(first opening the bathroom door)
The hinges of the door squeak as you open it and move through.

Bathroom
On your right is a bathtub, off-white with rings in some corners from shampoo bottles that once sat there. On your left is the bathroom counter, on which are some toothbrushes. Attached to the left wall is a large mirror.

>s
Floor boards creak and moan.

Play Room
You are in the play room. You used to spend all day in here with your toys. There is a pile of toys on the floor, discarded, old, and heavy used. To the north is a door with "Bath" written on it in fading gold paint. To the south is door with "Nursery" written on it in the same fading paint. To the east is a door with nothing written on it. Back to the west is the Foyer.

>s
(first opening the nursery door)
The hinges of the door squeak as you open it and move through.

Nursery
Covering the walls is a yellow patterned wallpaper, faded and peeling. On the opposite wall is the crib, blankets hang off the edge and through the open slots in the front you can see that the bed is haphazardly made. There's a brown cushy chair beside the crib where your parents used to sit when they read to you. The fuzz is worn down on the seat and in the middle of the back. To your immediate right is a dresser, chunks are missing from one of the legs where the door would always hit it. 

Above the crib hangs a mobile of the solar system. Saturn is missing a ring.

>n
Floor boards creak and moan.

Play Room
You are in the play room. You used to spend all day in here with your toys. There is a pile of toys on the floor, discarded, old, and heavy used. To the north is a door with "Bath" written on it in fading gold paint. To the south is door with "Nursery" written on it in the same fading paint. To the east is a door with nothing written on it. Back to the west is the Foyer.

>n
Dust clouds surround your feet as you walk.

Bathroom
On your right is a bathtub, off-white with rings in some corners from shampoo bottles that once sat there. On your left is the bathroom counter, on which are some toothbrushes. Attached to the left wall is a large mirror.

>x tub
You never cared for baths, still don't know a single child who did. Now you'd shower all day if you could, funny how things change. 

There's that whizzing sound again... Maybe the house will change again soon!

>x bottles
You can't see any such thing.

>x rings
You can't see any such thing.

>x counter
The grout in between the tiles is dark brown. There's a sink and a toothbrush container. 

It sounds as though something will happen like last time if you keep at it...

>x toothbrushes
The toothbrushes show signs of wear, the bristles not all pointing the same way. Brushing your teeth was always something you tolerated. Not great, but way better than the baths. 

There's that whizzing sound again... Maybe the house will change again soon!

>s
The hinges of the door squeak as you open it and move through.

Play Room
You are in the play room. You used to spend all day in here with your toys. There is a pile of toys on the floor, discarded, old, and heavy used. To the north is a door with "Bath" written on it in fading gold paint. To the south is door with "Nursery" written on it in the same fading paint. To the east is a door with nothing written on it. Back to the west is the Foyer.

>x toys
The toys are broken or nearly broken from intense use, no one ever said you were gentle with your toys. 

You hear the magic sound once again... You're excited for what may be coming soon.

>s
Floor boards creak and moan.

Nursery
Covering the walls is a yellow patterned wallpaper, faded and peeling. On the opposite wall is the crib, blankets hang off the edge and through the open slots in the front you can see that the bed is haphazardly made. There's a brown cushy chair beside the crib where your parents used to sit when they read to you. The fuzz is worn down on the seat and in the middle of the back. To your immediate right is a dresser, chunks are missing from one of the legs where the door would always hit it. 

Above the crib hangs a mobile of the solar system. Saturn is missing a ring.

>x wallpaper
The thin twisting white lines form that familiar pattern that stretches up to the ceiling. Bits of drywall are visible through the wallpaper where it's peeling or torn. 

There's that whizzing sound again... Maybe the house will change again soon!

>x crib
This is where you slept for a long while. You don't rememeber it being so agitated, but you were just a little kid. You can now understand the futility of making the bed for a child, your parents must have given up at some point. 

It sounds as though something will happen like last time if you keep at it...

Chapter 3: New Beginnings

The house becomes vibrant. Washed out colors return to their former glory, dirt and dust cease to exist, all signs of wear disappear. You'd like to look around now that everything's brand new and maybe pick up a few things for old time's sake.

Nursery
The walls are practically shining from the yellow. How did your parents stand being in this room? How did you stand being in this room? The crib is pristine, the little bed ready to be slept on, the blankets tucked in just right. The brown cushy chair is furry and welcoming. Your old dresser is clean and in tact.

The whole solar system is on the mobile, and hey!, there's Saturn's ring. 

It's like you never grew up... if only.

>l
Nursery
The walls are practically shining from the yellow. How did your parents stand being in this room? How did you stand being in this room? The crib is pristine, the little bed ready to be slept on, the blankets tucked in just right. The brown cushy chair is furry and welcoming. Your old dresser is clean and in tact.

The whole solar system is on the mobile, and hey!, there's Saturn's ring. 

You can also see your favorite blanket here.

>x blanket
Your childhood safety blanket. You slept with it every night and often brought it with you all over the house. Even now it makes you feel safe and you could use that security.

>take blanket
Taken.